SRCE	Financials
MMM	Industrials
AOS	Industrials
AAN	Consumer Discretionary
ABT	Health Care
ABBV	Health Care
ABM	Industrials
AKR	Real Estate
ACN	Information Technology
ACU	Industrials
ATVI	Communication Services
WMS	Industrials
AES	Utilities
AFL	Financials
AGCO	Industrials
A	Health Care
ADC	Real Estate
AL	Industrials
APD	Materials
AYR	Industrials
ALK	Industrials
ALB	Materials
ALX	Real Estate
ARE	Real Estate
ALLE	Industrials
ALE	Utilities
LNT	Utilities
ALL	Financials
AIMC	Industrials
MO	Consumer Staples
DOX	Information Technology
AEE	Utilities
AAT	Real Estate
ACC	Real Estate
AEP	Utilities
AEL	Financials
AXP	Financials
AFG	Financials
AWR	Utilities
AMT	Real Estate
AWK	Utilities
APU	Utilities
AMP	Financials
AMSF	Financials
ABC	Health Care
ATLO	Financials
AMGN	Health Care
APH	Information Technology
ADI	Information Technology
ANDX	Energy
ANDE	Consumer Staples
ANTM	Health Care
AON	Financials
AIV	Real Estate
APOG	Industrials
APLO	Financials
AAPL	Information Technology
AIT	Industrials
ATR	Materials
WTR	Utilities
ARMK	Consumer Discretionary
ABR	Financials
ADM	Consumer Staples
ARGO	Financials
AHH	Real Estate
AMNF	Consumer Staples
AROW	Financials
ARTNA	Utilities
AJG	Financials
ASH	Materials
ASB	Financials
AIZ	Financials
AGO	Financials
T	Communication Services
ATO	Utilities
ATRI	Health Care
AUBN	Financials
ALV	Consumer Discretionary
ADP	Information Technology
AVB	Real Estate
AVY	Materials
AVA	Utilities
AVT	Information Technology
AVX	Information Technology
AXS	Financials
BGS	Consumer Staples
BMI	Information Technology
BCPC	Materials
BANF	Financials
BXS	Financials
BAC	Financials
BORT	Financials
BMRC	Financials
BK	Financials
BKSC	Financials
BKUTK	Financials
OZK	Financials
BFIN	Financials
BANR	Financials
BHB	Financials
B	Industrials
BSET	Consumer Discretionary
BBT	Financials
BDX	Health Care
BMS	Materials
BBY	Consumer Discretionary
BIG	Consumer Discretionary
BKH	Utilities
BLK	Financials
BA	Industrials
BOKF	Financials
BAH	Information Technology
BWA	Consumer Discretionary
BPFH	Financials
BRC	Industrials
EAT	Consumer Discretionary
BMY	Health Care
BRX	Real Estate
AVGO	Information Technology
BR	Information Technology
BAM	Financials
BIP	Utilities
BPY	Real Estate
BEP	Utilities
BRO	Financials
BF-B	Consumer Staples
BC	Consumer Discretionary
BMTC	Financials
BT	Communication Services
BG	Consumer Staples
CFFI	Financials
CHRW	Industrials
CBT	Materials
CVGW	Consumer Staples
CWT	Utilities
TYCB	Financials
CATC	Financials
CPT	Real Estate
CNI	Industrials
CMD	Health Care
CCBG	Financials
CAH	Health Care
CTRE	Real Estate
CSL	Industrials
CARO	Financials
CRI	Consumer Discretionary
CASY	Consumer Staples
CASS	Information Technology
CAT	Industrials
CATY	Financials
CBOE	Financials
CCFN	Financials
CDW	Information Technology
FUN	Consumer Discretionary
CE	Materials
CNP	Utilities
CPF	Financials
CCF	Materials
CAKE	Consumer Discretionary
CHE	Health Care
CHFC	Financials
CPKF	Financials
CPK	Utilities
CVX	Energy
CHS	Consumer Discretionary
PLCE	Consumer Discretionary
CB	Financials
CHD	Consumer Staples
CHDN	Consumer Discretionary
CINF	Financials
CTAS	Industrials
CSCO	Information Technology
CZWI	Financials
CFG	Financials
CZFS	Financials
CHCO	Financials
CIVB	Financials
CWEN	Utilities
CLX	Consumer Staples
CME	Financials
CMS	Utilities
CNO	Financials
KO	Consumer Staples
CVLY	Financials
CCOI	Communication Services
CNS	Financials
CL	Consumer Staples
COLB	Financials
COLM	Consumer Discretionary
CMCSA	Communication Services
CMA	Financials
FIX	Industrials
CBSH	Financials
CBU	Financials
CTBI	Financials
CWBC	Financials
CSVI	Information Technology
CTWS	Utilities
ED	Utilities
CTO	Real Estate
CORE	Consumer Discretionary
COR	Real Estate
GLW	Information Technology
CLDB	Financials
COST	Consumer Staples
CBRL	Consumer Discretionary
CCI	Real Estate
CSGS	Information Technology
CSX	Industrials
CUBE	Real Estate
CFR	Financials
CULP	Consumer Discretionary
CMI	Industrials
CONE	Real Estate
DHI	Consumer Discretionary
DHR	Health Care
DKL	Energy
DAL	Industrials
XRAY	Health Care
DHIL	Financials
DLR	Real Estate
DDS	Consumer Discretionary
DFS	Financials
DLB	Information Technology
D	Utilities
DPZ	Consumer Discretionary
UFS	Materials
DCI	Industrials
DGICA	Financials
DGICB	Financials
PLOW	Industrials
DEI	Real Estate
DOV	Industrials
DTE	Utilities
DUK	Utilities
DNB	Industrials
DNKN	Consumer Discretionary
EBMT	Financials
EFSI	Financials
EGP	Real Estate
EMN	Materials
ETN	Industrials
EV	Financials
ECL	Materials
EIX	Utilities
EE	Utilities
EMCI	Financials
EMCF	Financials
EMR	Industrials
ENB	Energy
EHC	Health Care
ET	Energy
ENSG	Health Care
EBTC	Financials
EPD	Energy
EVC	Communication Services
EPR	Real Estate
EQM	Energy
ELS	Real Estate
ERIE	Financials
ESCA	Consumer Discretionary
ESS	Real Estate
EL	Consumer Staples
EVBN	Financials
EVR	Financials
RE	Financials
EVRG	Utilities
ES	Utilities
EXSR	Financials
EXPE	Consumer Discretionary
EXPD	Industrials
EXPO	Industrials
STAY	Consumer Discretionary
EXR	Real Estate
XOM	Energy
FMBM	Financials
FDS	Financials
FMCB	Financials
FMAO	Financials
FBVA	Financials
FAST	Industrials
FFG	Financials
AGM	Financials
FRT	Real Estate
FDX	Industrials
FNF	Financials
FITB	Financials
FISI	Financials
FAF	Financials
FNLC	Financials
BUSE	Financials
FBIZ	Financials
FCBC	Financials
FCCO	Financials
FDEF	Financials
FFMR	Financials
FFIN	Financials
THFF	Financials
FHN	Financials
FR	Real Estate
FIBK	Financials
FRME	Financials
FMBH	Financials
FMBI	Financials
FXNC	Financials
FLIC	Financials
FRC	Financials
FSFG	Financials
FLXS	Consumer Discretionary
FLIR	Information Technology
FLO	Consumer Staples
FFIC	Financials
FL	Consumer Discretionary
FORR	Industrials
FBHS	Industrials
FNV	Materials
FELE	Industrials
BEN	Financials
FSBW	Financials
GLPI	Real Estate
GLOP	Energy
GATX	Industrials
GD	Industrials
GIS	Consumer Staples
GNTX	Consumer Discretionary
GPC	Consumer Discretionary
GEO	Real Estate
GABC	Financials
GTY	Real Estate
GIL	Consumer Discretionary
GBCI	Financials
GAIN	Financials
GS	Financials
GT	Consumer Discretionary
GRC	Industrials
GGG	Industrials
GSBC	Financials
GBX	Industrials
GFF	Industrials
GPI	Consumer Discretionary
GBNK	Financials
GFED	Financials
FUL	Materials
HAFC	Financials
THG	Financials
HOG	Consumer Discretionary
HRS	Industrials
HIG	Financials
HAS	Consumer Discretionary
HVT	Consumer Discretionary
HVT-A	Consumer Discretionary
HWKN	Materials
HWBK	Financials
HDB	Financials
HCSG	Industrials
HTA	Real Estate
HLAN	Financials
HEI	Industrials
HP	Energy
HNNA	Financials
HTBK	Financials
HFWA	Financials
MLHR	Industrials
HSY	Consumer Staples
HI	Industrials
HRC	Health Care
HIFS	Financials
HNI	Industrials
HMLP	Energy
HEP	Energy
HBCP	Financials
HOMB	Financials
HD	Consumer Discretionary
HFBL	Financials
HONT	Financials
HON	Industrials
HOPE	Financials
HMN	Financials
HBNC	Financials
HRL	Consumer Staples
HPT	Real Estate
HPQ	Information Technology
HUBB	Industrials
HUM	Health Care
HBAN	Financials
HII	Industrials
HURC	Industrials
HY	Industrials
IDA	Utilities
IEX	Industrials
ITW	Industrials
IHC	Financials
INDB	Financials
IBCP	Financials
IBTX	Financials
IR	Industrials
INGR	Consumer Staples
IOSP	Materials
NSP	Industrials
IPAR	Consumer Staples
ICE	Financials
IDCC	Information Technology
TILE	Industrials
IBOC	Financials
IBM	Information Technology
IFF	Materials
IP	Materials
ISCA	Consumer Discretionary
IPG	Communication Services
INTU	Information Technology
IVZ	Financials
ISTR	Financials
ISBC	Financials
IRM	Real Estate
ISBA	Financials
ITT	Industrials
JJSF	Consumer Staples
SJM	Consumer Staples
JCOM	Information Technology
JKHY	Information Technology
JBHT	Industrials
JW-A	Communication Services
JNJ	Health Care
JCI	Industrials
JOUT	Consumer Discretionary
JLL	Real Estate
JPM	Financials
KAI	Industrials
KALU	Materials
KSU	Industrials
KAR	Industrials
K	Consumer Staples
KW	Real Estate
KEQU	Health Care
KEY	Financials
KMB	Consumer Staples
KIM	Real Estate
KINS	Financials
KRG	Real Estate
KLAC	Information Technology
KSS	Consumer Discretionary
KHC	Consumer Staples
KR	Consumer Staples
LLL	Industrials
LBAI	Financials
LKFN	Financials
LRCX	Information Technology
LAMR	Real Estate
LANC	Consumer Staples
LARK	Financials
LSTR	Industrials
LVS	Consumer Discretionary
LAZ	Financials
LZB	Consumer Discretionary
LEA	Consumer Discretionary
LTXB	Financials
LM	Financials
LEG	Consumer Discretionary
LMAT	Health Care
LII	Industrials
LXP	Real Estate
LSI	Real Estate
LMNR	Consumer Staples
LECO	Industrials
LNC	Financials
LIN	Industrials
LNN	Industrials
LAD	Consumer Discretionary
LFUS	Information Technology
LMT	Industrials
LOGN	Financials
LOGI	Information Technology
LOW	Consumer Discretionary
LYB	Materials
LYBC	Financials
MCBC	Financials
MAC	Real Estate
MFNC	Financials
MMP	Energy
MGA	Consumer Discretionary
MAIN	Financials
MLGF	Financials
LOAN	Financials
MAN	Industrials
MFC	Financials
MPC	Energy
MCS	Communication Services
MKTX	Financials
MNAT	Financials
VAC	Consumer Discretionary
MAR	Consumer Discretionary
MMC	Financials
MAS	Industrials
MA	Information Technology
MTRN	Materials
MATX	Industrials
MATW	Industrials
MXIM	Information Technology
MBFI	Financials
MKC	Consumer Staples
MCD	Consumer Discretionary
MGRC	Industrials
MCK	Health Care
MDU	Utilities
MPW	Real Estate
MDT	Health Care
MBWM	Financials
MRK	Health Care
MCY	Financials
MDP	Communication Services
MEOH	Materials
MET	Financials
MGEE	Utilities
MCHP	Information Technology
MSFT	Information Technology
MPB	Financials
MAA	Real Estate
MSEX	Utilities
MOFG	Financials
MKSI	Information Technology
MINI	Industrials
MC	Financials
MDLZ	Consumer Staples
TYPE	Information Technology
MNRO	Consumer Discretionary
MCO	Financials
MS	Financials
MORN	Financials
MSI	Information Technology
MPLX	Energy
MSA	Industrials
MSM	Industrials
MSCI	Financials
MYBF	Financials
MFSF	Financials
NC	Energy
NASB	Financials
NDAQ	Financials
NKSH	Financials
NFG	Utilities
NHI	Real Estate
NHC	Health Care
NATI	Information Technology
NNN	Real Estate
NHTC	Consumer Staples
NBTB	Financials
NP	Materials
NTAP	Information Technology
NJR	Utilities
NEWM	Communication Services
NRZ	Financials
NEU	Materials
NXST	Communication Services
NEE	Utilities
NEP	Utilities
NLSN	Industrials
NKE	Consumer Discretionary
NI	Utilities
NDSN	Industrials
NIDB	Financials
NTRS	Financials
NFBK	Financials
NRIM	Financials
NOC	Industrials
NWBI	Financials
NWN	Utilities
NWE	Utilities
NWFL	Financials
NUS	Consumer Staples
NUE	Materials
NVDA	Information Technology
OVLY	Financials
OXY	Energy
OCFC	Financials
OGE	Utilities
ODC	Consumer Staples
OLBK	Financials
ORI	Financials
OHI	Real Estate
OMC	Communication Services
OGS	Utilities
OLP	Real Estate
OKE	Energy
OTEX	Information Technology
ORCL	Information Technology
OSK	Industrials
OTTR	Utilities
OC	Industrials
ORM	Financials
OXM	Consumer Discretionary
GLT	Materials
PCAR	Industrials
PKG	Materials
PZZA	Consumer Discretionary
PKBK	Financials
PH	Industrials
PEGI	Utilities
PDCO	Health Care
PAYX	Information Technology
PBFX	Energy
PAG	Consumer Discretionary
PNR	Industrials
PEBK	Financials
PPLL	Financials
PBCT	Financials
PEP	Consumer Staples
PRGO	Health Care
PETS	Consumer Discretionary
PFE	Health Care
PM	Consumer Staples
PSX	Energy
PSXP	Energy
PPBN	Financials
PNW	Utilities
PNBI	Financials
PNC	Financials
PNM	Utilities
PII	Consumer Discretionary
POL	Materials
POOL	Consumer Discretionary
POR	Utilities
PTBS	Financials
POWI	Information Technology
PPG	Materials
PPL	Utilities
APTS	Real Estate
PFBC	Financials
PRI	Financials
PRIM	Industrials
PFG	Financials
PG	Consumer Staples
PLD	Real Estate
PB	Financials
PROV	Financials
PFS	Financials
PRU	Financials
PSB	Real Estate
PSBQ	Financials
PEG	Utilities
QNBC	Financials
QTS	Real Estate
QNTO	Financials
KWR	Materials
QCOM	Information Technology
DGX	Health Care
RJF	Financials
RTN	Industrials
RMAX	Real Estate
O	Real Estate
RBC	Industrials
REG	Real Estate
RF	Financials
RGA	Financials
RS	Materials
RNR	Financials
RBCAA	Financials
RSG	Industrials
RMD	Health Care
RECN	Industrials
ROIC	Real Estate
REXR	Real Estate
RGCO	Utilities
RBA	Industrials
RLI	Financials
RHI	Industrials
ROK	Industrials
ROL	Industrials
ROP	Industrials
ROST	Consumer Discretionary
RCL	Consumer Discretionary
RGLD	Materials
RPM	Materials
RUTH	Consumer Discretionary
R	Industrials
RHP	Real Estate
SPGI	Financials
STBA	Financials
SBRA	Real Estate
SAFM	Consumer Staples
SASR	Financials
BFS	Real Estate
SBFG	Financials
SWM	Materials
SMG	Materials
SEIC	Financials
SIGI	Financials
SRE	Utilities
SXT	Materials
SCI	Consumer Discretionary
SFBS	Financials
SHEN	Communication Services
SHW	Materials
SHPG	Health Care
SCVL	Consumer Discretionary
BSRR	Financials
SIG	Consumer Discretionary
SLGN	Materials
SFNC	Financials
SPG	Real Estate
SSD	Industrials
SBGI	Communication Services
SIX	Consumer Discretionary
SJW	Utilities
SWKS	Information Technology
SLG	Real Estate
SNA	Industrials
SON	Materials
SOHO	Real Estate
SFBC	Financials
SJI	Utilities
SSB	Financials
SO	Utilities
SOMC	Financials
SMBC	Financials
SBSI	Financials
LUV	Industrials
SWX	Utilities
SGB	Financials
SPTN	Consumer Staples
SR	Utilities
SRLP	Energy
STAG	Real Estate
SMP	Consumer Discretionary
SXI	Industrials
SWK	Industrials
SGU	Utilities
SBUX	Consumer Discretionary
STT	Financials
STLD	Materials
SCS	Industrials
SCL	Materials
STE	Health Care
SYBT	Financials
SYK	Health Care
STBI	Financials
INN	Real Estate
STI	Financials
SGC	Consumer Discretionary
SNX	Information Technology
SNV	Financials
SYY	Consumer Staples
TROW	Financials
SKT	Real Estate
TGT	Consumer Discretionary
TCO	Real Estate
AMTD	Financials
TEL	Information Technology
TDS	Communication Services
TNC	Industrials
TEX	Industrials
TRNO	Real Estate
TBNK	Financials
TTEK	Industrials
TXN	Information Technology
TPL	Energy
TXRH	Consumer Discretionary
TFSL	Financials
HCKT	Information Technology
THVB	Financials
TRI	Financials
THO	Consumer Discretionary
TIF	Consumer Discretionary
TSBK	Financials
TKR	Industrials
TJX	Consumer Discretionary
TMP	Financials
TR	Consumer Staples
TMK	Financials
TTC	Industrials
TOWN	Financials
TSCO	Consumer Discretionary
TLP	Energy
TRV	Financials
TCBK	Financials
TYBT	Financials
TRN	Industrials
TRUX	Financials
TRCB	Financials
TSN	Consumer Staples
USB	Financials
UDR	Real Estate
UGI	Utilities
UMBF	Financials
UMPQ	Financials
UBSH	Financials
UNB	Financials
UNP	Industrials
UBCP	Financials
UBSI	Financials
UCBI	Financials
UCFC	Financials
UFCS	Financials
UPS	Industrials
UTX	Industrials
UNH	Health Care
UNTY	Financials
UVV	Consumer Staples
UFPI	Industrials
UHT	Real Estate
UNM	Financials
UBA	Real Estate
USPH	Health Care
UTMD	Health Care
MTN	Consumer Discretionary
VLO	Energy
VLP	Energy
VGR	Consumer Staples
VVC	Utilities
VTR	Real Estate
VZ	Communication Services
VFC	Consumer Discretionary
V	Information Technology
VSEC	Industrials
VMC	Materials
WPC	Real Estate
WRB	Financials
WTBFA	Financials
GWW	Industrials
WBA	Consumer Staples
WMT	Consumer Staples
DIS	Communication Services
WAFD	Financials
WASH	Financials
WCN	Industrials
WM	Industrials
WSO	Industrials
WTS	Industrials
WDFC	Consumer Staples
WBS	Financials
WEC	Utilities
WRI	Real Estate
WEBK	Financials
WFC	Financials
WEN	Consumer Discretionary
WSBC	Financials
WTBA	Financials
WST	Health Care
WABC	Financials
WGP	Energy
WES	Energy
WAB	Industrials
WLK	Materials
WLKP	Materials
WRK	Materials
WHG	Financials
WEYS	Consumer Discretionary
WY	Real Estate
WHR	Consumer Discretionary
WMPN	Financials
WSM	Consumer Discretionary
WLTW	Financials
WINA	Consumer Discretionary
WTFC	Financials
WDFN	Financials
WOR	Materials
WPP	Communication Services
WSFS	Financials
WYND	Consumer Discretionary
XEL	Utilities
XLNX	Information Technology
XYL	Industrials
YORW	Utilities
ZION	Financials
ZTS	Health Care
